................................................................................
................................................................................
S@..............................................................................
LMMMMMMR........................................................................
T...............................................................................
V.W..........................E........................................LMMMMMMMR.
LMMMMMMMMMMMMMMMMMMMMMMMRBBBBBBBBBBBBBLMMMMR......LMMMMMMMMMMMMMMMMMMMMMMMR.....
................................................................................
