S...............................................................................
LMMMMMMR........................................................................
.............T..............E...................................................
LMMMMMMMMMMMMMMMMMMMMMMMMMMMMMMMR.....LMMMMR.......LMMMMMMMMMMMMMMMMMMMMMMMR....
................................................................................
